WWWWFWFWFWWFWFWFWWW
WRSB0SBS2SBBS4BSBBW
WBSBBSBSBSBBSBBSBBW
WBSBBSBSBSBBSBBSBBW
WBSBBS1SBSB3SBBSBBW
WWWWUWUWUWWUWUWSBBW
M5SBSBSBSBSBSBS6SBL
WSBSBWWWWWWWWWWUWWW
M7BBSSBB8LDSBSBSBSW
WBSBSBSBSWWWWWWWBSW
MSBSBSBS9SBSBSBSBSL
WWWWWWWWWWWWWWWWWWW
WWWWWWWWWWWWWWWWWWW