WWWWWWWWWWWWWWWWWWW
WSBSWFWFWFBBBBBBBBW
WBBBBSSSSSBBBWSBWWW
WSBSWBWBWBWWWWBSWWW
WWWWW0W1W2WWWWSBWWW
WSSSLUWUWUWWWWBSWWW
M3BBBBBBBBBBBBBBSSL
WSSSLFWFWFWFMSS8LWW
WSSSW3W4W5W6WSSSWDW
WSSSWBWBWBWBM9SSLBW
WSSSWBWBWBWBWWWWWSW
WSSSSSSSSSSSSSSSSSW
WWWWWUWUWUWUWWWWWWW