WFWWWFWFWWWWWWWWWWW
W0BBBSB1BBBBM8BBBBL
WSBBBSBSBWBBWSSSSSW
WSBBBSBSBWBBMBBBB9L
WSBBB3BSBWBBBBBBBBW
WUBBWUWUWWM6SSSSSLW
WMB5SSSSSSSBBBBBBLW
WWBBWWFWFWM7SSSSSLW
WBBBSS2SBSSBBBBBBBW
WBBBSSBSBSSBBBSSBBW
WBBBSSBSBSSBBBSSBBW
WRBBSSBS4SSBBBBBBDW
WWWWWWUWUWWWWWWWWWW