WWWWWWWWWWWWWWWWWWW
WBBBBWBBBWWBBBWBBBW
WBBBBM2SSSSSSBLBBBW
MBSSSBBB3LM4BBBSSSL
WBSSSBWWFWFWFWBSSSW
WBSSSBWSBW6SBBBSSSW
MBBBB1LWBSBSBWBBBBW
M0BBBBLS5SBS7WBBBBW
WBBSSBWWUBUFUFBBBBW
WBBSSBBBBWW8SSBSSSW
WBBSSBBBBWWSSSBSSSW
WBBSSBBDBWWSS9BSSSW
WWWWWWWWWWWUWUWWWWW